MODE 0
SIZE 8/8
LIMIT 0/20
COLOR LIMIT 5
STARS 8000/12000/15000
GETSTARS 3
10 10 10 10 00 10 10 10
10 10 10 10 00 10 10 10
10 10 10 10 15 10 10 10
10 10 10 10 15 10 10 10
10 10 10 10 00 00 00 00
10 10 10 10 10 10 10 10
10 10 10 10 10 10 10 10
10 10 10 10 10 10 10 10