MODE 1
SIZE 8/8
LIMIT 0/20
COLOR LIMIT 5
STARS 8000/12000/15000
COLLECT ITEMS 0/1/2/3/
COLLECT COUNT 0/0/4/4/
14 10 10 10 10 10 10 14
10 10 10 14 14 10 10 10
10 10 10 10 10 10 10 10
10 10 10 10 10 00 00 10
10 10 10 10 10 10 10 10
10 14 14 10 10 10 10 10
10 10 10 10 10 10 10 10
10 10 10 10 10 10 10 10