MODE 2
SIZE 8/8
LIMIT 0/20
COLOR LIMIT 5
STARS 8000/12000/15000
COLLECT ITEMS 0/4/
COLLECT COUNT 10/10/
00 00 00 10 10 00 00 00
00 00 10 10 10 10 00 00
00 10 10 10 10 10 10 00
10 10 10 10 10 10 10 10
10 10 10 10 10 10 10 10
10 10 10 10 10 10 10 10
10 10 10 15 14 10 10 10
10 10 10 10 10 10 10 10