MODE 4
SIZE 8/8
LIMIT 0/20
COLOR LIMIT 5
STARS 8000/12000/15000
CAGE 15
10 10 00 13 13 00 10 10
10 10 10 00 00 10 10 10
10 10 10 14 14 10 10 10
10 10 10 10 10 10 10 10
10 10 10 10 10 10 10 10
10 10 10 10 10 10 10 10
10 10 10 10 10 10 10 10
00 10 10 10 10 10 10 00