MODE 2
SIZE 8/8
LIMIT 0/20
COLOR LIMIT 6
STARS 8000/12000/15000
COLLECT ITEMS 0/1/2/3/4/5/
COLLECT COUNT 5/5/5/5/5/5/
10 10 10 10 10 10 10 10
10 10 10 10 10 10 10 10
10 10 10 14 14 10 10 10
10 10 14 00 00 10 10 10
10 10 14 00 00 10 10 10
10 10 10 14 14 10 10 10
10 10 10 10 10 10 10 10
10 10 10 10 10 10 10 10