MODE 3
SIZE 8/8
LIMIT 0/20
COLOR LIMIT 5
STARS 8000/12000/15000
COLLECT ITEMS 
10 10 10 10 10 10 10 10
10 10 10 15 15 10 10 10
10 10 15 60 60 15 10 10
10 15 60 60 60 60 15 10
10 15 60 60 60 60 15 10
10 15 60 60 60 60 15 10
10 10 15 60 60 15 10 10
10 10 10 10 10 10 10 10