MODE 3
SIZE 8/8
LIMIT 0/20
COLOR LIMIT 5
STARS 8000/12000/15000
COLLECT ITEMS 
60 60 60 10 10 10 10 10
60 60 60 10 10 10 10 10
10 10 10 10 10 10 10 10
10 10 10 00 14 10 10 10
10 10 10 14 00 10 10 10
10 10 10 10 10 10 10 10
10 10 10 10 10 60 60 60
10 10 10 10 10 60 60 60