MODE 0
SIZE 8/10
LIMIT 0/20
COLOR LIMIT 1
STARS 8000/12000/30000
GETSTARS 3
10 10 10 10 10 10 10 10
10 10 10 10 10 10 10 10
10 10 10 10 10 10 10 10
15 15 15 15 15 15 15 15
00 00 00 15 00 00 00 00
00 00 00 15 00 00 00 00
15 15 15 15 15 15 15 15
10 10 10 10 10 10 10 10
10 10 10 10 10 10 10 10
10 10 10 10 10 10 10 10