MODE 2
SIZE 8/8
LIMIT 0/20
COLOR LIMIT 6
STARS 8000/12000/15000
COLLECT ITEMS 5/
COLLECT COUNT 15/
15 10 10 10 10 10 10 10
10 15 10 10 10 10 10 10
10 10 10 15 10 10 10 10
10 10 10 10 15 15 10 10
10 10 10 10 10 10 15 10
15 15 10 10 10 10 10 10
10 10 10 10 10 10 10 10
10 10 10 10 10 10 10 10