MODE 2
SIZE 8/8
LIMIT 0/20
COLOR LIMIT 6
STARS 8000/12000/15000
COLLECT ITEMS 2/
COLLECT COUNT 15/
00 10 10 10 10 10 10 00
10 10 10 10 10 10 10 10
10 10 10 10 10 10 10 10
10 10 10 10 10 10 10 10
10 10 10 10 10 10 10 10
10 10 10 10 10 10 10 10
15 10 10 10 10 10 10 15
00 15 10 10 10 10 15 00