MODE 0
SIZE 8/8
LIMIT 0/20
COLOR LIMIT 4
STARS 8000/12000/15000
GETSTARS 3
00 00 10 10 10 10 00 00
00 10 10 10 10 10 10 00
10 10 10 10 10 10 10 10
10 10 10 10 10 10 10 10
10 10 10 10 10 10 10 10
10 10 10 15 15 10 10 10
10 10 15 15 15 14 10 10
10 10 17 00 00 17 10 10