MODE 2
SIZE 8/10
LIMIT 0/25
COLOR LIMIT 6
STARS 8000/12000/15000
COLLECT ITEMS 0/1/2/3/4/5/
COLLECT COUNT 7/7/7/7/7/7/
10 10 10 10 10 10 10 10
10 10 15 10 10 15 10 10
10 15 15 10 10 15 15 10
10 10 10 10 10 10 10 10
10 10 10 18 18 10 10 10
10 10 10 10 10 10 10 10
10 15 15 10 10 15 15 10
10 15 10 10 10 10 15 10
10 10 10 10 10 10 10 10
10 10 10 10 10 10 10 10