MODE 0
SIZE 8/10
LIMIT 0/25
COLOR LIMIT 5
STARS 8000/12000/15000
GETSTARS 3
10 10 10 10 10 10 10 10
10 10 10 10 10 10 10 10
18 00 14 14 14 10 10 10
00 00 00 00 14 10 10 10
18 00 14 14 14 10 10 10
10 10 10 10 10 10 10 10
10 10 10 10 10 10 10 10
10 10 10 10 10 10 10 10
10 10 10 10 10 10 10 10
10 10 10 10 00 00 00 00