MODE 3
SIZE 8/10
LIMIT 0/25
COLOR LIMIT 4
STARS 8000/12000/15000
COLLECT ITEMS 0/1/2/3/
60 60 60 60 60 60 60 60
60 60 60 60 60 60 60 60
15 15 17 10 10 17 15 15
10 10 10 10 10 10 10 10
10 10 10 10 10 10 10 10
10 10 10 10 10 10 10 10
10 10 10 10 10 10 10 10
10 10 10 10 10 10 10 10
60 60 60 60 60 60 60 60
60 60 60 60 60 60 60 60