MODE 3
SIZE 8/10
LIMIT 0/25
COLOR LIMIT 5
STARS 8000/12000/15000
COLLECT ITEMS 
60 60 17 10 10 10 10 10
60 60 17 10 10 10 10 10
60 60 17 10 10 10 10 10
60 60 17 10 10 10 10 10
60 60 17 10 10 10 10 10
60 60 17 10 10 10 10 10
17 17 17 10 10 10 10 10
10 10 10 10 10 10 10 10
10 10 10 10 10 10 10 00
10 10 10 10 10 10 00 00