MODE 2
SIZE 8/8
LIMIT 1/120
COLOR LIMIT 5
STARS 8000/12000/15000
COLLECT ITEMS 0/4/
COLLECT COUNT 15/15/
15 15 10 10 10 10 10 10
15 10 10 10 10 10 15 10
10 10 10 10 10 15 15 10
10 10 10 10 10 10 10 10
10 15 10 10 10 10 10 10
10 15 15 10 10 10 10 10
10 10 10 10 10 10 10 15
10 10 10 10 10 10 15 15