MODE 4
SIZE 8/6
LIMIT 0/25
COLOR LIMIT 4
STARS 8000/12000/15000
CAGE 15
10 10 10 15 15 10 10 10
10 10 10 10 10 10 10 10
10 10 10 10 10 10 10 10
10 10 10 10 10 10 10 10
17 17 10 10 10 10 17 17
13 17 10 10 10 10 17 13