MODE 2
SIZE 8/8
LIMIT 0/25
COLOR LIMIT 6
STARS 8000/12000/15000
COLLECT ITEMS 0/3/5/
COLLECT COUNT 7/7/7/
10 10 17 10 10 17 10 10
10 10 10 10 10 10 10 10
10 10 15 10 10 15 10 10
10 10 10 14 14 10 10 10
10 10 10 14 14 10 10 10
10 10 15 10 10 15 10 10
10 10 10 10 10 10 10 10
10 17 10 10 10 10 17 10