MODE 5
SIZE 8/8
LIMIT 0/25
COLOR LIMIT 6
STARS 8000/12000/15000
GETSTARS 3
BOMBS 10/15
10 14 10 10 10 10 14 10
14 14 14 10 10 14 14 14
10 14 10 10 10 10 14 10
10 10 10 10 10 10 10 10
10 10 10 10 10 10 10 10
10 10 14 10 10 14 10 10
10 10 10 14 14 10 10 10
10 10 14 10 10 14 10 10