MODE 3
SIZE 8/8
LIMIT 0/25
COLOR LIMIT 6
STARS 8000/12000/15000
COLLECT ITEMS 0/1/2/3/
10 10 10 10 10 10 10 10
10 10 10 10 10 10 10 10
10 10 17 60 60 17 10 10
10 60 60 60 60 60 60 10
10 60 60 60 60 60 60 10
10 10 17 60 60 17 10 10
10 10 10 10 10 10 10 10
10 10 10 10 10 10 10 10