MODE 4
SIZE 8/8
LIMIT 0/25
COLOR LIMIT 5
STARS 8000/12000/15000
CAGE 15
17 10 10 10 10 10 10 17
10 10 10 10 10 10 10 10
10 10 10 10 10 10 10 10
10 10 10 10 10 10 10 10
15 15 15 15 10 10 10 10
10 10 10 15 10 10 10 10
13 10 10 15 10 10 10 17
13 13 10 15 10 10 17 17