MODE 2
SIZE 8/8
LIMIT 0/25
COLOR LIMIT 5
STARS 8000/12000/15000
COLLECT ITEMS 0/1/2/4/
COLLECT COUNT 40/40/40/40/
10 10 10 10 10 10 10 10
15 15 10 10 10 10 15 15
15 15 10 10 10 10 15 15
10 10 10 10 10 10 10 10
10 10 10 14 14 10 10 10
17 10 10 10 10 10 10 17
10 10 10 10 10 10 10 10
10 10 10 10 10 10 10 10