MODE 5
SIZE 8/8
LIMIT 1/120
COLOR LIMIT 5
STARS 8000/12000/15000
GETSTARS 3
BOMBS 10/15
00 10 10 10 10 10 10 00
10 10 10 10 10 10 10 10
15 10 15 15 15 15 10 15
10 10 10 10 10 10 10 10
10 10 10 10 10 10 10 10
10 10 10 10 10 10 10 10
10 10 10 10 10 10 10 10
00 10 10 17 17 10 10 00