MODE 1
SIZE 8/10
LIMIT 0/25
COLOR LIMIT 2
STARS 8000/12000/15000
COLLECT ITEMS 0/1/2/3/
COLLECT COUNT 0/0/0/15/
10 10 10 10 10 10 10 10
10 10 10 10 10 10 10 10
10 10 10 10 10 10 10 10
17 17 10 10 10 10 17 17
10 10 10 10 10 10 10 10
10 10 10 10 17 10 10 10
10 10 10 17 10 10 10 10
10 10 10 15 15 10 10 10
10 10 10 15 15 10 10 10
10 10 10 15 15 10 10 10