MODE 4
SIZE 8/10
LIMIT 0/25
COLOR LIMIT 4
STARS 8000/12000/15000
CAGE 2
10 10 10 10 10 10 10 10
13 10 10 10 10 10 10 13
17 10 10 10 10 10 10 17
10 10 10 10 17 10 10 10
10 10 10 13 10 10 10 10
10 17 10 17 10 10 17 10
10 10 10 10 10 10 10 10
10 10 17 10 10 17 10 10
10 10 10 10 10 10 10 10
10 10 10 10 10 10 10 10