MODE 0
SIZE 8/10
LIMIT 1/120
COLOR LIMIT 3
STARS 8000/12000/15000
GETSTARS 3
10 10 10 10 10 10 10 10
10 10 10 10 10 10 10 10
10 10 17 17 17 17 10 10
10 10 17 10 10 17 10 10
10 10 17 10 17 17 10 10
10 10 17 10 10 10 10 10
10 10 17 17 17 17 17 10
10 10 10 10 10 10 17 10
10 10 17 17 17 17 17 10
10 10 10 10 10 10 10 10