MODE 3
SIZE 8/10
LIMIT 0/25
COLOR LIMIT 2
STARS 8000/12000/15000
COLLECT ITEMS 
00 60 60 60 60 60 60 00
00 60 60 60 60 60 60 00
00 60 60 60 60 60 60 00
00 17 17 10 10 17 17 00
00 00 00 00 00 00 00 00
00 10 10 10 10 10 10 00
10 10 10 10 10 10 10 10
10 10 15 15 15 15 10 10
10 10 15 60 60 15 10 10
10 10 15 60 60 15 10 10