MODE 0
SIZE 8/8
LIMIT 0/25
COLOR LIMIT 1
STARS 8000/12000/15000
GETSTARS 3
10 10 10 10 10 10 10 10
10 18 18 18 18 18 18 10
10 18 10 10 10 10 18 10
10 18 10 17 17 10 18 10
10 18 10 17 17 10 18 10
10 18 10 10 10 10 18 10
10 18 18 18 18 18 18 10
10 10 10 10 10 10 10 10