MODE 1
SIZE 8/8
LIMIT 0/20
COLOR LIMIT 5
STARS 5000/8000/12000
COLLECT ITEMS 0/1/2/3/
COLLECT COUNT 0/0/3/3/
00 10 10 00 00 10 10 00
00 10 10 00 00 10 10 00
00 10 10 00 00 10 10 00
00 18 18 00 00 18 18 00
10 10 10 10 10 10 10 10
10 10 10 10 10 10 10 10
10 10 10 10 10 10 10 10
10 10 10 10 10 10 10 10