MODE 1
SIZE 8/8
LIMIT 0/20
COLOR LIMIT 5
STARS 5000/8000/12000
COLLECT ITEMS 0/1/2/3/
COLLECT COUNT 0/3/3/0/
10 10 10 10 10 10 10 10
10 10 10 10 10 10 10 10
10 10 10 10 10 10 10 10
10 10 10 10 10 10 10 10
14 14 14 14 14 14 14 14
14 14 18 10 14 14 18 10
14 14 10 10 14 14 10 10
14 14 14 14 14 14 14 14