MODE 2
SIZE 8/8
LIMIT 0/20
COLOR LIMIT 5
STARS 10000/15000/18000
COLLECT ITEMS 2/3/4/
COLLECT COUNT 20/20/20/
00 00 10 10 10 10 00 00
00 00 10 10 10 10 00 00
10 10 10 10 10 10 10 10
10 10 14 10 10 14 10 10
10 10 14 10 10 14 10 10
14 14 15 14 14 15 14 14
00 00 10 10 10 10 00 00
00 00 10 10 10 10 00 00