MODE 3
SIZE 8/8
LIMIT 0/30
COLOR LIMIT 4
STARS 7000/14000/17000
COLLECT ITEMS 
10 10 10 10 10 10 10 10
10 10 10 10 10 10 10 10
10 10 00 20 20 00 10 10
14 15 00 20 20 00 15 14
60 00 00 20 20 00 00 60
00 00 14 20 20 14 00 00
10 10 14 20 20 14 10 10
10 10 10 10 10 10 10 10