MODE 4
SIZE 8/8
LIMIT 0/25
COLOR LIMIT 5
STARS 7000/14000/17000
CAGE 20
00 10 10 10 10 10 10 00
10 10 10 10 10 10 10 10
10 10 10 10 10 10 10 10
10 10 13 10 10 13 10 10
10 17 17 10 10 17 17 10
10 10 17 10 10 17 10 10
10 10 13 10 10 13 10 10
00 10 10 10 10 10 10 00