MODE 2
SIZE 8/8
LIMIT 0/30
COLOR LIMIT 5
STARS 7000/14000/17000
COLLECT ITEMS 0/2/
COLLECT COUNT 30/30/
14 14 14 10 10 14 14 14
14 14 17 10 10 17 14 14
14 17 14 10 10 14 17 14
14 17 14 10 10 14 17 14
14 17 14 10 10 14 17 14
14 17 14 10 10 14 17 14
14 14 17 10 10 17 14 14
14 14 14 10 10 14 14 14