MODE 3
SIZE 8/8
LIMIT 0/30
COLOR LIMIT 5
STARS 7000/14000/17000
COLLECT ITEMS 0/1/
10 10 10 10 10 10 10 10
10 10 17 60 10 10 10 10
10 10 17 17 60 10 10 10
10 10 60 17 17 60 10 10
10 10 10 60 17 17 10 10
10 10 10 10 60 17 10 10
10 10 10 10 10 10 10 10
10 10 10 10 10 10 10 10