MODE 3
SIZE 8/10
LIMIT 0/20
COLOR LIMIT 5
STARS 8000/12000/15000
COLLECT ITEMS 
10 10 10 10 10 10 10 10
10 10 10 10 10 10 10 10
10 10 10 10 10 10 10 10
10 10 10 10 10 10 10 10
10 10 10 10 10 10 10 10
10 10 10 10 10 10 10 10
20 20 20 20 20 20 20 20
00 00 00 00 00 00 00 00
00 00 00 00 00 00 00 00
20 20 20 20 20 20 20 20