MODE 4
SIZE 8/8
LIMIT 0/20
COLOR LIMIT 5
STARS 10000/13000/17000
CAGE 25
00 00 00 10 10 00 00 00
00 00 13 10 10 10 00 00
00 15 10 10 10 10 15 00
15 15 10 10 10 10 15 15
15 15 10 10 10 10 15 15
15 15 10 10 10 10 15 15
00 15 15 10 10 15 15 00
00 00 15 10 13 15 00 00