MODE 2
SIZE 8/7
LIMIT 0/15
COLOR LIMIT 5
STARS 5000/7000/8000
COLLECT ITEMS 0/1/3/
COLLECT COUNT 10/10/10/
10 10 10 10 10 10 10 10
10 00 10 10 10 10 00 10
10 10 00 17 10 00 10 10
10 10 10 10 17 10 10 10
10 10 10 10 10 10 10 10
10 10 10 10 10 10 10 10
10 10 10 10 10 10 10 10