MODE 3
SIZE 8/7
LIMIT 1/60
COLOR LIMIT 5
STARS 5000/7000/8000
COLLECT ITEMS 
20 20 20 10 10 10 10 10
20 20 20 10 10 15 60 00
20 20 20 10 10 60 15 10
20 20 20 10 10 00 10 10
20 20 20 10 10 10 10 10
20 20 20 10 10 10 10 10
20 20 20 10 10 10 10 10